1111111111111111111
1000P000E00000C1111
1111111111111111111
