111111111111111111111111111111111111111111111111111111111111111111111111111111111111
100000000000000000000000000000000000000000000000000000000000000000000000000000000001
1000000000000000000000P0000000000000000000000000000000000000000000000000000000000001
100011111111111111111111111111111111111111100000000000000000000000000000000000000001
100010000000000000000000000000000000000000100000000000000000000000000000000000000001
100010000000000000000000000000000000000000100000000000000000000000000000000000000001
100011111111111111111111111111111111111111100000000000000000000000000000000000000001
100000000000000000000000000000000000000000000000000000000000000000000000000000000001
100000000000000000000000000000000000000000000000000000000000000000000000000000000001
111111111111111111111111111111111111111111111111111111111111111111111111111111111111
100000000000000000000000000000000000000000000000000000000000000000000000000000000001
100000000000000000000000000000000000000000000000000000000000000000000000000000000001
100011111111111111111111111111111111111111100000000000000000000000000000000000000001
100010000000000000000000000000000000000000100000000000000000000000000000000000000001
100010000000000000000000000000000000000000100000000000000000000000000000000000000001
100011111111111111111111111111111111111111100000000000000000000000000000000000000001
100000000000000000000000000000000000000000000000000000000000000000000000000000000001
100000000000000000000000000000000000000000000000000000000000000000000000000000000001
111111111111111111111111111111111111111111111111111111111111111111111111111111111111
100000000000000000000000000000000000000000000000000000000000000000000000000000000001
100000000000000000000000000000000000000000000000000000000000000000000000000000000001
100011111111111111111111111111111111111111100000000000000000000000000000000000000001
100010000000000000000000000000000000000000100000000000000000000000000000000000000001
100010000000000000000000000000000000000000100000000000000000000000000000000000000001
100011111111111111111111111111111111111111100000000000000000000000000000000000000001
100000000000000000000000000000000000000000000000000000000000000000000000000000000001
100000000000000000000000000000000000000000000000000000000000000000000000000000000001
111111111111111111111111111111111111111111111111111111111111111111111111111111111111
100000000000000000000000000000000000000000000000000000000000000000000000000000000001
100000000000000000000000000000000000000000000000000000000000000000000000000000000001
100011111111111111111111111111111111111111100000000000000000000000000000000000000001
100010000000000000000000000000000000000000100000000000000000000000000000000000000001
100010000000000000000000000000000000000000100000000000000000000000000000000000000001
100011111111111111111111111111111111111111100000000000000000000000000000000000000001
100000000000000000000000000000000000000000000000000000000000000000000000000000000001
100000000000000000000000000000000000000000000000000000000000000000000000000000000001
111111111111111111111111111111111111111111111111111111111111111111111111111111111111

