11111
1P0C1
1P1E1
1C0E1
11111
