111111111111111111111111111111
1P0000000000C00000000011111111
100000001111100000000011000011
100C00001100011000000010000011
100000001000001111110110000011
100000001000000000000010000011
100C000001000000000000C0000011
100000000000000000000011110011
100000000000000000000010000011
111100000000000000000010000011
1C0000000000000000000010000011
10000000000000000000000E0000C1
100000000011111000000110000011
1C0000000000000000000010000011
100000000000000000000010000011
1C0000000000000000000010000011
111111111111111111111111111111
