1111111111111111111
10000011000CC100111
100001110000011C111
10000CCC1010CCC0001
1P000011100CC100111
100001110000011C111
1111111111111110E11
1111111111111111111
