1111111111111111111111111111111
1000000000000010000000000000011
1000000011111011111000000000011
1000000010000000001000000000011
1000000010001111101000000000011
1000000010000000101000000000011
1000000011111100101111110000011
1000000000000100000000010000011
1000000000000100000000010000011
1000000111111101111110010000011
1000000100000000000010010000011
1000000100000000000010010000011
1000000111111111111110010000011
1000000000000000000010000000011
10P0000000000000000010000E00011
1111111111111111111111111111111
