1111111111111111111111111111111111111111111111111111111111111111111111111111111111111111111111111111111111111111
100000000000000000000000000000000000000000000000000000000000000000000000000000000000000000000000000000000000PCE1
1111111111111111111111111111111111111111111111111111100111111111111111111111111111111111111111111111111111111111
1111111111111111111111111111111111111111111111111111100111111111111111111111111111111111111111111111111111111111
1111111111111111111111111111111111111111111111111111100111111111111111111111111111111111111111111111111111111111
100000000000000000000000000000000000000000000000000000000000000000000000000000000000000000000000000000000000CC01
1111111111111111111111111111111111111111111111111111100111111111111111111111111111111111111111111111111111111111
1111111111111111111111111111111111111111111111111111100111111111111111111111111111111111111111111111111111111111
1111111111111111111111111111111111111111111111111111100111111111111111111111111111111111111111111111111111111111
100000000000000000000000000000000000000000000000000000000000000000000000000000000000000000000000000000000000CC01
1111111111111111111111111111111111111111111111111111100111111111111111111111111111111111111111111111111111111111
1111111111111111111111111111111111111111111111111111100111111111111111111111111111111111111111111111111111111111
1111111111111111111111111111111111111111111111111111100111111111111111111111111111111111111111111111111111111111
1000000000000000000000000000000000000000000000000000000000000000000000000000000000000000000000000000000000000C01
1111111111111111111111111111111111111111111111111111100111111111111111111111111111111111111111111111111111111111
1111111111111111111111111111111111111111111111111111100111111111111111111111111111111111111111111111111111111111
1111111111111111111111111111111111111111111111111111100111111111111111111111111111111111111111111111111111111111
1000000000000000000000000000000000000000000000000000000000000000000000000000000000000000000000000000000000000C01
1111111111111111111111111111111111111111111111111111100111111111111111111111111111111111111111111111111111111111
1111111111111111111111111111111111111111111111111111100111111111111111111111111111111111111111111111111111111111
1111111111111111111111111111111111111111111111111111100111111111111111111111111111111111111111111111111111111111
1000000000000000000000000000000000000000000000000000000000000000000000000000000000000000000000000000000000000C01
1111111111111111111111111111111111111111111111111111100111111111111111111111111111111111111111111111111111111111
1111111111111111111111111111111111111111111111111111100111111111111111111111111111111111111111111111111111111111
1111111111111111111111111111111111111111111111111111100111111111111111111111111111111111111111111111111111111111
1000000000000000000000000000000000000000000000000000000000000000000000000000000000000000000000000000000000000C01
1111111111111111111111111111111111111111111111111111100111111111111111111111111111111111111111111111111111111111
1111111111111111111111111111111111111111111111111111100111111111111111111111111111111111111111111111111111111111
1111111111111111111111111111111111111111111111111111100111111111111111111111111111111111111111111111111111111111
1000000000000000000000000000000000000000000000000000000000000000000000000000000000000000000000000000000000000C01
1111111111111111111111111111111111111111111111111111111111111111111111111111111111111111111111111111111111111111
1111111111111111111111111111111111111111111111111111111111111111111111111111111111111111111111111111111111111111
